**********
*   P     *
*        *
*     **********************************************
***   Z   *                                         *
*     ****                                         *
**                                                 *
********************                       *********  
                   *                       *
                   *************************