**********
*        *
*        *
*     **********************************************
***      *                                         *
*     ****                                         *
**                                                 *
********************                       *********  
                   *                       *
                   *************************