**********
*        *
*        *
*     ****
***      
*     ***                                        
**************