**********
*   P     *
*        *
*     ****
***      
*     ***                                        
**************