**********
*   P     *
*        *
*     ****
***      
* Z    ***                                        
**************